################
#   X  @       #
#  GGGGGGGG    #
#              #
#              #
#              #
#              #
#              #
#  #########   #
#  odddddddo   #
#      d       #
#      d       #
#  odddddddo   #
#  #########   #
#   CCCCCCC    #
################
