################
#      @    #  #
#           #XX#
#  d        #  #
#             G#
#     d       G#
#             G#
#  d       d  G#
#             G#
#    d         #
#              #
#        d     #
#  d           #
#          d   #
#C            C#
################
